same : одинаковый, тот же, такой же
cat  : кошка, кот, котенок
frog : лягушка, жаба
dog : собака, пёс
caveat : предостережение
retrive : извлекать, заберать
persistent : постоянный
transient : переходящий, временный
detached : обособленный, отдельный
evict : выселять, изгонять
mention : упамянуть, упоменать
to bundle : связывать, объеденять
consistency : последовательность
pristine : первоночально (состояние)
fairly : довольно, весьма
clearly : четко, ясно
lurks : скрываться, скрыть
confusion : путаница, запутанно
mitigate : смягчать, уменьшать
internal : внутренний
entrie : запись
correspond : соответствовать
allow : позволять
event : событие
particular : особый, специфический
instance : экземпляр, образец
for instance : например
thus : таким образом
distinguish : отличать
therefore : поэтому
to provide : представлять
determine : определять, утанавливать
appropriate : соответствующий, подходящий
omit : пропускать
omitted : опущенный(пропущенный)
either : или, либо
assume : предпологать
whatsoever : что бы то нибыло
tends to yield : имеет тендецию уступать
relie : пологаться